"filename", "language", "Go", "HTML", "PostCSS", "Markdown", "comment", "blank", "total"
"c:\Users\josec\OneDrive\Documentos\AUTISMO\GOLANGUEANDO\README.md", "Markdown", 0, 0, 0, 107, 0, 56, 163
"c:\Users\josec\OneDrive\Documentos\AUTISMO\GOLANGUEANDO\cmd\web\routes.go", "Go", 27, 0, 0, 0, 7, 12, 46
"c:\Users\josec\OneDrive\Documentos\AUTISMO\GOLANGUEANDO\pkg\handlers\handlers.go", "Go", 919, 0, 0, 0, 38, 167, 1124
"c:\Users\josec\OneDrive\Documentos\AUTISMO\GOLANGUEANDO\pkg\handlers\helpers.go", "Go", 687, 0, 0, 0, 13, 107, 807
"c:\Users\josec\OneDrive\Documentos\AUTISMO\GOLANGUEANDO\pkg\models\licitaciones.go", "Go", 16, 0, 0, 0, 1, 2, 19
"c:\Users\josec\OneDrive\Documentos\AUTISMO\GOLANGUEANDO\pkg\models\partidas.go", "Go", 79, 0, 0, 0, 7, 19, 105
"c:\Users\josec\OneDrive\Documentos\AUTISMO\GOLANGUEANDO\pkg\models\templatedata.go", "Go", 10, 0, 0, 0, 7, 7, 24
"c:\Users\josec\OneDrive\Documentos\AUTISMO\GOLANGUEANDO\static\css\styles.css", "PostCSS", 0, 0, 31, 0, 5, 4, 40
"c:\Users\josec\OneDrive\Documentos\AUTISMO\GOLANGUEANDO\templates\base\base.layout.tmpl", "HTML", 0, 1, 0, 0, 1, 1, 3
"c:\Users\josec\OneDrive\Documentos\AUTISMO\GOLANGUEANDO\templates\licitaciones\aclaraciones-licitacion.page.tmpl", "HTML", 0, 45, 0, 0, 0, 4, 49
"c:\Users\josec\OneDrive\Documentos\AUTISMO\GOLANGUEANDO\templates\licitaciones\aclaraciones.page.tmpl", "HTML", 0, 27, 0, 0, 0, 0, 27
"c:\Users\josec\OneDrive\Documentos\AUTISMO\GOLANGUEANDO\templates\licitaciones\editar-propuesta.page.tmpl", "HTML", 0, 84, 0, 0, 0, 11, 95
"c:\Users\josec\OneDrive\Documentos\AUTISMO\GOLANGUEANDO\templates\licitaciones\mostrar-partidas.page.tmpl", "HTML", 0, 43, 0, 0, 0, 6, 49
"c:\Users\josec\OneDrive\Documentos\AUTISMO\GOLANGUEANDO\templates\licitaciones\nueva-aclaracion-licitacion.page.tmpl", "HTML", 0, 89, 0, 0, 9, 7, 105
"c:\Users\josec\OneDrive\Documentos\AUTISMO\GOLANGUEANDO\templates\licitaciones\nueva-aclaracion.page.tmpl", "HTML", 0, 77, 0, 0, 8, 13, 98
"c:\Users\josec\OneDrive\Documentos\AUTISMO\GOLANGUEANDO\templates\licitaciones\nueva-partida2.page.tmpl", "HTML", 0, -8, 0, 0, -1, -1, -10
"c:\Users\josec\OneDrive\Documentos\AUTISMO\GOLANGUEANDO\templates\licitaciones\nueva-propuesta.page.tmpl", "HTML", 0, 140, 0, 0, 1, 15, 156
"c:\Users\josec\OneDrive\Documentos\AUTISMO\GOLANGUEANDO\templates\licitaciones\nuevo-producto-partida.page.tmpl", "HTML", 0, 105, 0, 0, 2, 2, 109
"c:\Users\josec\OneDrive\Documentos\AUTISMO\GOLANGUEANDO\templates\licitaciones\productos-partida.page.tmpl", "HTML", 0, 96, 0, 0, 1, 10, 107
"c:\Users\josec\OneDrive\Documentos\AUTISMO\GOLANGUEANDO\templates\licitaciones\propuestas.page.tmpl", "HTML", 0, 176, 0, 0, 1, 24, 201
"c:\Users\josec\OneDrive\Documentos\AUTISMO\GOLANGUEANDO\templates\opciones\empresas-externas.page.tmpl", "HTML", 0, 61, 0, 0, 1, 2, 64
"c:\Users\josec\OneDrive\Documentos\AUTISMO\GOLANGUEANDO\templates\opciones\productos-externos.page.tmpl", "HTML", 0, 103, 0, 0, 1, 6, 110
"Total", "-", 1738, 1039, 31, 107, 102, 474, 3491